111111111111111111111111111111111111111111111111111111111111
1000000000T00C00000010T000000000T00000000000T0000001000T0001
1C000C000000000000001C000000000000T000C000T00000000100000001
100000000000000000001000000000000000000000000001000000000001
10000000000000T000000000000000000000000000000C00000100C000E1
1000000000100000000C101000000T000001111110000000000111111011
1000111111000000000000110000000000010C001000T000000000000011
10001001001111100000001111110100111100T0100000000000000001C1
10P0100000T0111100T01010000001100001000110000001111111111001
100010000000110000001010000001000000101000000011C00000000001
10000000111111000011C001100000000000000T00000011111111111001
100000000C11C1100000000000T000000C00000000000101000000000001
10000000001101000011T0011000000000000000T000000000T111111001
100000000001000000001010000000000000000000000000000000000001
1C000000000100000100101000000T000000T000000001010011100C0001
10000000000000000111100000000101000000000000001000T010000001
10000000C000000001001011111110001111111111111110000C11111001
10000T000000000000000100000001010000000000C00010000011C00T01
100000000000T000000000000000000000T0000000000000T00011000001
111111111111111111111111111111111111111111111111111111111111