11111111
10T01001
101000C1
1E0000P1
11111111