111111111111111111111111111111
100E000000000C0000000000000001
1C000C000000000000001000000001
100000000000000000001000000001
1000000000100000000C1010000001
100011111100000000000011000001
100010010011111000000011000001
10P010000000111100000000000001
100010000000000000000000000001
100000001111110000000000000001
100000000011C11000000000000001
100000000011010000000000000001
1C0000000001000000000000000001
111111111111111111111111111111